+---------+
|R: | : :G|
| : | : : |
| : : : : |
| | : | : |
|Y| : |B: |
+---------+


+---------+
|R: | : :G|
| : | : : |
| : : : : |
| | : | : |
|Y| : |B: |
+---------+
  (West)

+---------+
|R: | : :G|
| : | : : |
| : : : : |
| | : | : |
|Y| : |B: |
+---------+
  (West)

+---------+
|R: | : :G|
| : | : : |
| : : : : |
| | : | : |
|Y| : |B: |
+---------+
  (West)

+---------+
|R: | : :G|
| : | : : |
| : : : : |
| | : | : |
|Y| : |B: |
+---------+
  (North)

+---------+
|R: | : :G|
| : | : : |
| : : : : |
| | : | : |
|Y| : |B: |
+---------+
  (West)

+---------+
|R: | : :G|
| : | : : |
| : : : : |
| | : | : |
|Y| : |B: |
+---------+
  (North)

+---------+
|R: | : :G|
| : | : : |
| : : : : |
| | : | : |
|Y| : |B: |
+---------+
  (Pickup)

+---------+
|R: | : :G|
|_: | : : |
| : : : : |
| | : | : |
|Y| : |B: |
+---------+
  (South)

+---------+
|R: | : :G|
| :_| : : |
| : : : : |
| | : | : |
|Y| : |B: |
+---------+
  (East)

+---------+
|R: | : :G|
| : | : : |
| :_: : : |
| | : | : |
|Y| : |B: |
+---------+
  (South)

+---------+
|R: | : :G|
| : | : : |
| : :_: : |
| | : | : |
|Y| : |B: |
+---------+
  (East)

+---------+
|R: | : :G|
| : | : : |
| : : :_: |
| | : | : |
|Y| : |B: |
+---------+
  (East)

+---------+
|R: | : :G|
| : | : : |
| : : : : |
| | : |_: |
|Y| : |B: |
+---------+
  (South)

+---------+
|R: | : :G|
| : | : : |
| : : : : |
| | : | : |
|Y| : |B: |
+---------+
  (South)